2.3 - Not so easy
2
8,8
[],1S,3N,[],[],[],2S,[]
[],[],[],3E,[],[],[],3N
[],5E,[],[],3N,[],3E,5S
3E,5N,[],5S,3N,[],[],5W
[],[],[],[],[],[],[],[]
[],[],[],3E,[],3N,[],[]
3N,[],[],[],[],[],[],3E
[],2N,3E,[],[],3E,1N,[]