2.7 - There is another
2
7,7
3E,[],3N,2S,[],[],[]
[],3E,[],[],[],3N,[]
[],[],[],5S,3N,[],[]
[],3E,[],5W,[],[],7W
[],[],[],[],3N,[],3E
[],3N,[],[],[],[],3E
[],[],3N,1N,[],3E,[]