2.2 - Spot the difference
2
7,9
1E,5W,[],3N,4N,3E,[],5S,1W
3E,[],3N,[],4N,[],3E,[],3N
[],[],[],[],4N,[],[],[],[]
3N,5S,[],3N,4N,3E,[],5W,3E
[],[],[],[],4N,[],[],[],[]
[],[],3E,3N,4N,3E,[],3N,[]
3N,3N,[],2N,4N,2N,[],3E,3E