2.6 - The doughnut
2
11,11
[],[],3E,3E,[],4N,3N,3N,5S,5W,[]
2E,5S,[],5W,3N,6N,3E,3N,[],3N,1W
[],[],[],3N,3N,4N,5N,[],3E,[],[]
3E,[],3N,4N,4N,4N,6E,4N,5S,5N,[]
3N,[],5S,4N,[],5W,[],4N,3N,[],3N
4N,6E,4N,4N,5S,[],5S,4N,4N,6E,4N
3E,5N,[],4N,[],5W,[],4N,[],3E,3E
3N,[],3N,4N,6E,4N,4N,4N,3E,3N,[]
[],3E,[],[],3E,4N,[],3E,[],[],[]
[],[],[],[],3N,6N,[],5E,[],5W,[]
[],2N,[],[],[],4N,[],[],3N,1N,3N