1.2 - More mirrors
1
7,7
[],[],[],2S,[],[],[]
3W,[],3N,[],[],[],[]
[],[],[],[],[],[],[]
[],[],3W,3W,[],[],3N
[],[],[],[],[],[],[]
3W,[],[],[],[],[],3N
[],[],[],1N,[],[],[]