1.3 - WALL-E
1
5,7
[],[],[],[],[],[],[]
[],[],[],4N,[],[],[]
2E,3N,[],4N,[],3W,1W
[],[],[],4N,[],[],[]
[],3N,[],[],[],3W,[]