1.4 - Twirl
1
7,7
1S,[],[],[],2S,[],[]
[],3W,[],[],[],[],3W
[],[],3W,[],[],3N,[]
[],[],[],4N,[],[],[]
[],[],3N,[],3W,[],[]
[],3N,[],[],[],3N,[]
3N,[],[],[],[],[],3W