1.5 - All the way around
1
5,8
3N,[],[],[],3N,4N,3E,3E
[],[],[],[],[],[],[],[]
[],3E,[],[],3N,[],[],3E
3N,[],[],[],3E,[],[],[]
[],1N,[],[],[],[],2N,[]