1.7 - Maze
1
7,11
4N,3E,[],[],[],[],[],[],[],3N,[]
[],[],4N,4N,4N,4N,4N,[],4N,[],4N
3E,3E,4N,3E,[],3E,[],[],[],3E,4N
[],[],4N,[],4N,[],4N,4N,4N,[],[]
3N,[],[],3N,4N,1N,4N,[],[],3E,3N
4N,[],4N,[],4N,4N,4N,4N,[],4N,[]
3E,[],4N,3E,[],[],2W,4N,3N,[],3N