1.9 - Choice
1
7,7
4N,3E,[],5S,5N,[],3N
3E,[],3E,[],[],4N,[]
[],[],[],[],3E,3E,[]
1E,[],5S,5S,5S,[],[]
[],[],[],[],4N,[],[]
3N,5N,[],[],[],[],3N
[],[],[],2N,[],[],[]