1.10 - The end (of the beginning)
1
9,13
[],3E,[],5S,[],3N,4N,3N,3E,[],[],3E,3N
3E,[],3N,[],[],[],4N,[],5E,[],[],5W,[]
[],[],[],[],[],[],4N,[],3E,[],3N,[],[]
3N,[],[],3E,3N,[],4N,[],[],[],[],[],[]
2E,5W,[],[],[],3E,[],5S,3N,5S,[],5N,1W
[],[],[],[],[],[],4N,[],[],[],[],[],[]
3N,[],5S,5N,[],[],4N,[],[],[],[],[],[]
[],3E,[],3E,3N,[],4N,3E,[],5W,[],3E,[]
3N,[],[],[],[],3E,4N,3N,[],[],[],[],3N